. 2 . . 9 . 7 . 5
3 9 . . . 7 . . .
. . 1 . . . 9 . 8
. . . . . 3 . 1 .
6 . . . 5 . . . 7
. 5 . 1 . . . . .
7 . 8 . . . 4 . .
. . . 3 . . . 7 6
5 . 2 . 6 . . 8 .

9 . . . 5 6 1 . 7
. . 8 . . . . . 3
. . 4 . . 9 . . .
. . . . . 5 . 4 6
. . . . . . . . .
7 3 . 2 . . . . .
. . . 9 . . 5 . .
8 . . . . . 6 . .
5 . 2 7 3 . . . 8

. . 2 . . . 8 . .
. 3 . 1 . 7 . 9 .
4 . . . . 6 . . 1
. 5 6 . . . . 2 .
. . . . 9 . . . .
. 7 . . . . 4 5 .
8 . . 3 . . . . 6
. 9 . 2 . 8 . 7 .
. . 1 . . . 9 . .

8 . 2 . . . . 5 .
. . . . . 2 . . 4
3 . . . 7 . . . .
. . . 5 . . . 2 .
. . 1 . 6 . 8 . .
. 4 . . . 9 . . .
. . . . 4 . . . 7
7 . . 8 . . . . .
. 5 . . . . 3 . 9

. 9 8 . . . . . .
. . . . 7 . . . .
. . . . 1 5 . . .
1 . . . . . . . .
. . . 2 . . . . 9
. . . 9 . 6 . 8 2
. . . . . . . 3 .
5 . 1 . . . . . .
. . . 4 . . . 2 .
